19x20x64          
        []         
  ###### !######   
 #              #  
 #              #  
 #  """"  """"  #  
 #  "        "  #  
 #  "        "  #  
 #  "        "  #  
[       ^       ![ 
]!               ] 
 #  "        "  #  
 #  "        "  #  
 #  "       %"  #  
 #  """"  """"  #  
 #              #  
 #              #  
  ######! ######   
        []          