                   
        ??         
  &&&&&&&&&&&&&&   
  &&&&&&&&&&&&&&   
  &&    @@    &&   
  && ++++++++ &&   
  && ++++++++ &&   
  && ++++++++ &&   
 ?&&@++++++++@&&?  
 ?&&@++++++++@&&?  
  && ++++++++ &&   
  && ++++++++ &&   
  && ++++++++ &&   
  &&    @@    &&   
  &&&&&&&&&&&&&&   
  &&&&&&&&&&&&&&   
        ??         
                    