15x15x64
     #####     
     # + #     
  !### $ ###!  
  #    .    #  
  #         #  
###  !---!  ###
#    - ! -    #
#+$. -!!!- .$+#
#    - ! -    #
###  !---!  ###
  #         #  
  #    .    #  
  !### $ ###!  
     # + #     
     #####     
